NO ./assets/north.xpm
SO ./assets/south.xpm
WE ./assets/west.xpm
EA ./assets/east.xpm

F 180,170,150
C 60, 120, 200

1111111111111111111111111
1000000000000000000000001
10110000000000000W0000001
100100000000000000000000011111111
111111111011000001110000000000001
100000000011111000001110111111111
111101111111  1111111 11 111 1 11
111101111111110111010100100011111
111111111111111111111111111111111


1111111111111111111111111111111111111111111111111111111111111111111111