NO ./assets/floor.xpm
SO ./assets/wall.xpm
WE ./assets/wall0.xpm
EA ./assets/c_door.xpm

F 255,50,255
C 0,0,0
   
1111111
1110001
10N0001
1111111 