NO ./assets/floor.xpm
SO ./assets/wall.xpm
WE ./assets/wall0.xpm
EA ./assets/c_door.xpm

F 255,50,255
C 0,0,0
   
1111111111111111111
1000000000000000001
1000000000000000001
1000000000000000001
10000000N0000000001
1000000000000000001
1000000000000000001
1000000000000000001
1111111111111111111