NO ./assets/floor.xpm
SO ./assets/wall.xpm
WE ./assets/wall0.xpm
EA ./assets/c_door.xpm

F 255,50,255
C 0,0,0
   
1111111
1110001
1000W01
1111111 