NO ./assets/north.xpm
SO ./assets/south.xpm
WE ./assets/west.xpm
EA ./assets/east.xpm

F 180,170,150
C 235,235,240


1111111111111111111111111
1000000000000000000000001
1011000000000000000000001
100100000000N00000000000011111111
111111111011000001110000000000001
1000000000111110000011101111111111111111
111101111111  1111111 11 111  1101110001
1111011111111101110101001000111111111111
1111111111111111111111111111111111111111
