1111111111111111111111111
1000000000110000000000001
1011000001110000000000001
10010000000000000000000011111111
111111111011000001110000000000001
100000000011111000001110111111111111111111111111111111111111111111
111101111111  1111111 11 111                      11011100000010001
111101111111110111010100100011111111111111111111111111111111111111
110000001101010111111111111111100000010001
100000000000000011000000100011111111111111
100000000000000011010100100011111
1100111110001110101011111011110N0111
11110111 1110101 1011110100011111
11111111 1111111 1111111111111