NO ./assets/floor.xpm
SO ./assets/wall.xpm
WE ./assets/wall0.xpm
EA ./assets/c_door.xpm

F 255,50,255
C 0,0,0


1111111111111111111111111
1000000000000000000000001
1011000000000000000000001
100100000000N00000000000011111111
111111111011000001110000000000001
100000000011111000001110111111111111111111111111111111111111111111
111101111111  1111111 11 111                      11011100000010001
111101111111110111010100100011111111111111111111111111111111111111
111111111111111111111111111111111111111111111111111111111111111111
