NO ./assets/north.xpm
SO ./assets/south.xpm
WE ./assets/west.xpm
EA ./assets/east.xpm

F 180,170,150
C 235,235,240


111111111111111111111111111111111111111111111
100000000000000000000000000000000000000000001
100000000000000000000000000000000000000000001
100000000000000000000000000000000000000000001
100000000000000011111111111111110000000000001
100000000000000000000000000001 10000000000001
100000000000000000000000000001110000000000001
100000000000000000000000N00000000000000000001
111111111111111111111111111111111111111111111