NO ./assets/wall.xpm
SO ./assets/wall.xpm
WE ./assets/wall0.xpm
EA ./assets/c_door.xpm

F 66,59,74
C 50,168,164
   
   1111111111111111
1110000000000000001
1000000000000000001
1000000000000000001
10000000N0000000001
1000000000000000001
1000000000000000001
1000000000000000001
1111111111111111111