NO ./assets/north.xpm
SO ./assets/south.xpm
WE ./assets/west.xpm
EA ./assets/east.xpm

F 66,59,74
C 50,168,164
   
1111111111111
1000000000001
1000000000001
10001N0000001
1000000000001
1111111111111