1111111111111111111111111
1000000000110000000000001
1011000001110000000000001
1001000000000000000N000011111111
111111111011000001110000000000001
111111111111111111111111111111111