NO ./assets/north.xpm
SO ./assets/south.xpm
WE ./assets/west.xpm
EA ./assets/east.xpm

F 60,120,200
C 180,170,200


1111111111111111111111111
1000000000000000000001111
10110000000000000000N00011
110010000000000000000000001111111
111111111011000001110000000000001
110000001111111001001110111111111
111101111111  1111111 11 111 1 11
111101111111110111010100100011111
111111111111111111111111000000001
111111111111111111111111111111111
111111111111111111111111111111111








