

NO ./assets/north.xpm
SO ./assets/south.xpm
WE ./assets/west.xpm
EA ./assets/east.xpm
F 120, 5, 200
C 60,150,200


111111111111
1N0000000001
100000000001
100011111101
1111     111
111111111111