NO ./assets/north.xpm
SO ./assets/south.xpm
WE ./assets/west.xpm
EA ./assets/east.xpm

F 60, 120, 200
C 180,170,200

1111111111111111111111111
1000000000000000000001111
10110000000000000000000011
110010000000000000000000001111111
11111111101100000111000000000000N
100000000011111000001110111111111
111101111111  1111111 11 111 1 11
111101111111110111010100100011111
111111111111111111111111000000001
111111111111111111111111111111111

